11.ox
..o.........o.......
.........o..........
...........o..o.....
....o...............
................o...
..................o.
.......o.......o....
.................oo.
....................
....................
...........o........
